11111111111111111111
1P000000000000100111
10001111100000100001
10100000000000010001
11100001111000100101
10000000010000100011
10010000010000100001
11010000011100010101
10111000000000001101
10000011001100100001
11100010000010011111
10001111000111110001
10000000100000001001
11110000111100000101
10100000100000000001
10100111110000100001
10001100000000100111
10000100011100111001
10000001000010000001
11111111111111111111